------------------English to Yoruba------------------
ọmọkunrin = boy
omobirin = girl
obinrin = woman
ọkọ = husband
iyawo = wife
ọmọ = child
ọkàn = heart
ọwó = money
ilé = house
ọdún = year
ọsán = month
ọjó = day
ọsẹ = work
ara = body
inú = stomach
ojú = eye
eniyan =person
irú = nose
Eni = somebody
Orí = head
ikẹkọ = school
ìwé = book
ìròyìn = newspaper
Ilé-ẹ̀kọ = classroom
Aya = woman
ọmọde = child
àbùrò = younger sibling
Màmá = mother
Bàbá = father
Je = to eat
Mu = to drink
Ja = to sleep
Ji = to wake up
Jo = to run
Bo = to walk
Wa = to sit
Dúró = to stand
Keji = big
Lekan = small
Emi ni = i am
Okurin ni mi = i am a boy
Ore = friend


-------------Greetings---------------
Ẹ̀ kú = good
Bàwo ni? = how are you?
Mo wa láàyọ̀ = i am fine
Ẹ̀ kú ọjọ́ = good day
Ẹ̀ káàrọ̀ = good morning
Ẹ̀ káàsán = good afternoon
Ẹ̀ kúrọ̀lẹ́ = good evening
Ẹ̀ káalẹ́ = good night
Ẹ̀ kú ilé = welcome home
Ẹ̀ kú ọdún = happy new year
Ẹ̀ kú ọmọ = congratulations on having a child
Mo dùkẹ́ = i greet you
Báwo ló ṣe ìlera rẹ̀? = how is your health?
Mo ti pé = i am well
Ṣé o lọ́ sàn? = are you well?
Mo dúpẹ́ = thank you
Máa wà = take care
Ẹ̀ kú ìdí ibì = welcome to my place
Ẹ̀ kú ìrìn = have a safe journey
Ọ̀pọ̀ ọdún = many happy returns
Ẹ̀ n lẹ́ = hello
Ẹ̀ n lẹ́ = hi